###################
#.................#
#.@.....S.....O...#
#.................#
#.................#
#.................#
#.................#
###################